100000000111111111111111111111111111111111111111111111111111111111111111000000000
100000000111111111111111111111111111111111111111111111111111111111111111000000000
100000000111111111111111111111111111111111111111111111111111111111111111000000000
111100111111111111111111111100000000000000000011111111111111111111111111000000000
111100111111110000000000000000000111100002000011111111111111111111111111000000000
111100000000000000000000111111111111100000000011111111111111111111111111000000000
111100111111110000000000000000000111111111111111111111111111111111111111000000000
111100111111111111111111111111100000000000000111111111111111111111111111000000000
111100111111111111111111111111100000020000200111111111111111111111111111000000000
111100111111111111111111111111100000000000000111111111111111111111111111000000000
111112111111111111111111111111111111100111111111111111111111111111111111000000000
111111111111111111111111111111111111100111111111111111111111111111111111000000000
111111111111111111111111111111111111100111111111111111111111111111111111000000000
111111111111111111111111111111111111100111111111111111111111111111111111000000000
111111111111111111111111100000000000000000000000000021111111111111111111000000000
111111111111111111111111200000000000000000000000000001111111111111111111000000000
111111111111111111111111111111111111100111111111111111111111111111111111000000000
111111111111111111111111111111111111100111111111111111111111111111111111000000000
111111111111111111111111111111111111100111111111111111111111111111111111000000000
111111111111111111111111111111111111100111111111111111111111111111111111000000000
111111111111111111111111111111111111100111111111111111111111111111111111000000000
111111111111111111111111111111100000000000000011111111111111111111111111000000000
111111111111111111111111111111100000000000000011111111111111111111111111000000000
111111111111111111111111111111100000000000000011111111111111111111111111000000000
111111111111111111111111111111111112111111211111111111111111111111111111000000000
111111111111111111111111111111111111111111111111111111111111111111111111000000000
111111111111111111111111111111111111111111111111111111111111111111111111000000000
111111111111111111111111111111111111111111111111111111111111111111111111000000000
111111111111111111111111111111111111111111111111111111111111111111111111000000000
111111111111111111111111111111111111111111111111111111111111111111111111000000000
111111111111111111111111111111111111111111111111111111111111111111111111000000000
111111111111111111111111111111111111111111111111111111111111111111111111000000000
111111111111111111111111111111111111111111111111111111111111111111111111000000000
111111111111111111111111111111111111111111111111111111111111111111111111000000000
111111111111111111111111111111111111111111111111111111111111111111111111000000000
111111111111111111111111111111111111111111111111111111111111111111111111000000000
111111111111111111111111111111111111111111111111111111111111111111111111000000000
111111111111111111111111111111111111111111111111111111111111111111111111000000000
000000000000000000000000000000000000000000000000000000000000000000000000000000000
000000000000000000000000000000000000000000000000000000000000000000000000000000000
000000000000000000000000000000000000000000000000000000000000000000000000000000000
000000000000000000000000000000000000000000000000000000000000000000000000000000000
000000000000000000000000000000000000000000000000000000000000000000000000000000000
000000000000000000000000000000000000000000000000000000000000000000000000000000000
000000000000000000000000000000000000000000000000000000000000000000000000000000000
000000000000000000000000000000000000000000000000000000000000000000000000000000000
000000000000000000000000000000000000000000000000000000000000000000000000000000000