100000000111111111111111111111111111111111111111111111111111111111111111000000000
100000000111111111111111111111111111111111111111111111111111111111111111000000000
100000000111111111111111111111111111111111111111111111111111111111111111000000000
111100111100000000000000111100000000000000111111111111111111111111111111000000000
111100111100000000000000111100000000000000111111111111111111111111111111000000000
111100111100000000020000111100000000000000111111111111111111111111111111000000000
111100000000000000000000000000000000000000111111111111100000011111111111000000000
111100000000000000000000000000000000000000111111111111100000011111111111000000000
111111111100000000000000111100000000200000111111111111100000011111111111000000000
111111111100000000000000111100000000000000111111111111100000011111111111000000000
111111111111111111111111111111111001111111111111111111101111111111111111000000000
111111111111111111111111111111111001111111111111111111101111111111111111000000000
111111111111111111111111111111111001111111111111111111101111111111111111000000000
111111111111111111111111120000000000000000021111111111101111111111111111000000000
111111111111111111111111100000000000000000001111111111101111111111111111000000000   
111111111111111111111111100000000000000000001111111111101111111111111111000000000
111111111111111111111111100000000000000000000000000000001111111111111111000000000
111111111111111111111111100000000000000000001111111111111111111111111111000000000
111111111111111111111111100000000000000000001111111111111111111111111111000000000
111111111111111111111111100000000000000000001111111111111111111111111111000000000
111111111111111111111111120000000000000000021111111111111111111111111111000000000
111111111111111111111111111111111100111111111111111111111111111111111111000000000
111111111111111111111111111111111100111111111111111111111111111111111111000000000
111111111111111111111111111111111100111111111111111111111111111111111111000000000
111111111111111111111111111111111100111111111111111111111111111111111111000000000
100000000000000000000000000000000000000000000000000000000000000000000001000000000
100000000000000000000000000000030000000000000000000000000000000000000001000000000
100000000000000000000000000000000000000000000000000000000000000000000001000000000
100000000000000000000000000000000000000000000000000000000000000000000001000000000
100000000000000000000000000000000000000000000000000000000000000000000001000000000
100000000000000000000000000000000000000000000000000000000000000000000001000000000
100000000000000000000000000000000000000000000000000000000000000000000001000000000
100000000000000000000000000000000000000000000000000000000000000000000001000000000
100000000000000000000000000000000000000000000000000000000000000000000001000000000
100000000000000000000000000000000000000000000000000000000000000000000001000000000
100000000000000000000000000000000000000000000000000000000000000000000001000000000
100000000000000000000000000000000000000000000000000000000000000000000001000000000
111111111111111111111111111111111111111111111111111111111111111111111111000000000
000000000000000000000000000000000000000000000000000000000000000000000000000000000
000000000000000000000000000000000000000000000000000000000000000000000000000000000
000000000000000000000000000000000000000000000000000000000000000000000000000000000
000000000000000000000000000000000000000000000000000000000000000000000000000000000
000000000000000000000000000000000000000000000000000000000000000000000000000000000
000000000000000000000000000000000000000000000000000000000000000000000000000000000
000000000000000000000000000000000000000000000000000000000000000000000000000000000
000000000000000000000000000000000000000000000000000000000000000000000000000000000
000000000000000000000000000000000000000000000000000000000000000000000000000000000