100000000111111111111111111111111111111111111111111111111111111111111111000000000
100000000111111111111111111111111111111111111111111111111111111111111111000000000
100000000111111111111111111111111111111111111111111111111111111111111111000000000
111100111111111111111111111111111111111111111111000000000000021111111111000000000
111100111111111111111111111111111111111111111111000000000000021111111111000000000
111100111111111111111111111111111111111000000000001111111111111111111111000000000
111100111111111111111111111111111111111000020000001111111111111111111111000000000
111100111111111111111111111111111111111001111111111111111111111111111111000000000
111100111111111111111111111111111111111001111111111111111111111111111111000000000
100000000000002011111111111111111000000000000011111111111111111111111111000000000
100000000000000011111111111111111000200000000011111111111111111111111111000000000
100000000000000000000000000000000000000000000011111111111111111111111111000000000
100000000000000000000000000000000000000000000011111111111111111111111111000000000
100000000002000011111111111111111000000000000011111111111111111111111111000000000
100000000000000011111111111111111000000000020011111111111111111111111111000000000
111111111111111111111111111111111111111001111111111111111111111111111111000000000
111111111111111111111111111111111111111001111111111111111111111111111111000000000
111111111111111111111111111111111111111001111111111111111111111111111111000000000
111111111111111111111111111111111111111001111111111111111111111111111111000000000
111111111111111111111111111111111111111001111111111111111111111111111111000000000
111111111111111111111111111111111111111001111111111111111111111111111111000000000
111102000000001111111111111111100000000000000001111111111111111111111111000000000
111100000000001111111100000000000000000000000001111111111111111111111111000000000
111101111111000000200000111111120200000000000001111111111111111111111111000000000
111101111111111111111100000000000000000000000001111111111111111111111111000000000
111101111111111111111111111111100000000002000001111111111111111111111111000000000
111101111111111111111111111111111111111111111101111111111111111111111111000000000
111101111111111111111111111111111111111111111101111111111111111111111111000000000
111101111111111111111111111111111111111111111101111111111111111111111111000000000
111101111111111111111111111111111111111111111101111111111111111111111111000000000
111100000000000011111111111111111111111111111101111111111111111111111111000000000
111100000000000211111111111111111111111111111101111111111111111111111111000000000
111111111111111111111111111111111111111111111100000001111111111111111111000000000
111111111111111111111111111111111111111111111100000021111111111111111111000000000
111111111111111111111111111111111111111111111111111111111111111111111111000000000
111111111111111111111111111111111111111111111111111111111111111111111111000000000
111111111111111111111111111111111111111111111111111111111111111111111111000000000
111111111111111111111111111111111111111111111111111111111111111111111111000000000
000000000000000000000000000000000000000000000000000000000000000000000000000000000
000000000000000000000000000000000000000000000000000000000000000000000000000000000
000000000000000000000000000000000000000000000000000000000000000000000000000000000
000000000000000000000000000000000000000000000000000000000000000000000000000000000
000000000000000000000000000000000000000000000000000000000000000000000000000000000
000000000000000000000000000000000000000000000000000000000000000000000000000000000
000000000000000000000000000000000000000000000000000000000000000000000000000000000
000000000000000000000000000000000000000000000000000000000000000000000000000000000
000000000000000000000000000000000000000000000000000000000000000000000000000000000