100000000111111111111111111111111111111111111111111111111111111111111111000000000
100000000111111111111111111111111111111111111111111111111111111111111111000000000
100000000111111111111111111111111111111111111111111111111111111111111111000000000
111100111111111111111111111111111111111111111111000000000000021111111111000000000
111100111111111111111111111111111111111111111111000000000000021111111111000000000
111100111111111111111111111111111111111000000000001111111111111111111111000000000
111100111111111111111111111111111111111000020000001111111111111111111111000000000
111100111111111111111111111111111111111001111111111111111111111111111111000000000
111100111111111111111111111111111111111001111111111111111111111111111111000000000
100000004000004011111111111111111000000000000011111111111111111111111111000000000
100000000000000011111111111111111000300000000011111111111111111111111111000000000
100000000000000000000700000000000010000000000011111111111111111111111111000000000
100000000000000000000700000000000010000000000011111111111111111111111111000000000
100000000004000011111111111111111000000003000011111111111111111111111111000000000
100000000000000011111111111111111000000000000011111111111111111111111111000000000
111111111111111111111111111111111111111001111111111111111111111111111111000000000
111111111111111111111111111111111111111001111111111111111111111111111111000000000
111111111111111111111111111111111111111001111111111111111111111111111111000000000
111111111111111111111111111111111111111001111111111111111111111111111111000000000
111111111111111111111111111111111111111001111111111111111111111111111111000000000
111111111111111111111111111111111111111001111111111111111111111111111111000000000
111102000000001111111111111111100000000000000001111111111111111111111111000000000
111100000000001111111100007000000040404000404041111111111111111111111111000000000
111101111111000000000004111111100000000000000001111111111111111111111111000000000
111101111111111111111100000000000040000000000001111111111111111111111111000000000
111101111111111111111111111111100000000002000001111111111111111111111111000000000
111101111111111111111111111111111111111111111101111111111111111111111111000000000
111101111111111111111111111111111111111111111101111111111111111111111111000000000
111101111111111111111111111111111111111111111101111111111111111111111111000000000
111101111111111111111111111111111111111111111101111111111111111111111111000000000
111100000000000011111111111111111111111111111101111111111111111111111111000000000
111100000000000211111111111111111111111111111101111111111111111111111111000000000
111111111111111111111111111111111111111111111100000001111111111111111111000000000
111111111111111111111111111111111111111111111100000021111111111111111111000000000
111111111111111111111111111111111111111111111111111111111111111111111111000000000
111111111111111111111111111111111111111111111111111111111111111111111111000000000
111111111111111111111111111111111111111111111111111111111111111111111111000000000
111111111111111111111111111111111111111111111111111111111111111111111111000000000
000000000000000000000000000000000000000000000000000000000000000000000000000000000
000000000000000000000000000000000000000000000000000000000000000000000000000000000
000000000000000000000000000000000000000000000000000000000000000000000000000000000
000000000000000000000000000000000000000000000000000000000000000000000000000000000
000000000000000000000000000000000000000000000000000000000000000000000000000000000
000000000000000000000000000000000000000000000000000000000000000000000000000000000
000000000000000000000000000000000000000000000000000000000000000000000000000000000
000000000000000000000000000000000000000000000000000000000000000000000000000000000
000000000000000000000000000000000000000000000000000000000000000000000000000000000