100000000111111111111111111111111111111111111111111111111111111111111111000000000
100000000111111111111111111111111111111111111111111111111111111111111111000000000
100000000111111111111111111111111111111111111111111111111111111111111111000000000
111100111100000000000000111100000000000000111111111111111111111111111111000000000
111100111102000000000200111100200000000200111111111111111111111111111111000000000
111100111100000000000000111100000000000000111111111111111111111111111111000000000
111100000000000000000000000000000000000000111111111111100000011111111111000000000
111100000000000000000000000000000000000000111111111111100000011111111111000000000
111111111102000000000200111100200000000200111111111111100000011111111111000000000
111111111100000000000000111100000000000000111111111111100000011111111111000000000
111111111111111111111111111111111001111111111111111111101111111111111111000000000
111111111111111111111111111111111001111111111111111111101111111111111111000000000
111111111111111111111111111111111001111111111111111111101111111111111111000000000
111111111111111111111111120000000000000000021111111111101111111111111111000000000
111111111111111111111111100000000000000000001111111111101111111111111111000000000   
111111111111111111111111100000000000000000001111111111101111111111111111000000000
111111111111111111111111100000000000000000000000000000001111111111111111000000000
111111111111111111111111100000000000000000001111111111111111111111111111000000000
111111111111111111111111100000000000000000001111111111111111111111111111000000000
111111111111111111111111100000000000000000001111111111111111111111111111000000000
111111111111111111111111120000000000000000021111111111111111111111111111000000000
111111111111111111111111111111111100111111111111111111111111111111111111000000000
111111111111111111111111111111111100111111111111111111111111111111111111000000000
111111111111111111111111111111111100111111111111111111111111111111111111000000000
111111111111111111111111111111111100111111111111111111111111111111111111000000000
100000002000000000000000000020000000000000020000000000000020000000000001000000000
100000000000000200000000000000000000000000000000002000000000000000000001000000000
100000000000000000000000000000000000000000000000000000000000000000000001000000000
100000000000000000002000000000000000000000000000000000000002000000000001000000000
100000000000000000000000000000020000000000000000000000000002000000000001000000000
100000002000000000000000000000000000000000020000000000000000000000000001000000000
100000000000000000000000000000000000000000000000000000000000000000000001000000000
100000000002000000000000000000000000000000000000000000000002000000000001000000000
100000000000000000000000000000000000000000000000000000000000000000000001000000000
100000000000000020000000000000000000000000000000002000000000000000000001000000000
100000000000000000000000000200000000002000000000000000000000000000000001000000000
100000000000000000000000000000000000000000000000002000000000000000000001000000000
111111111111111111111111111111111111111111111111111111111111111111111111000000000
000000000000000000000000000000000000000000000000000000000000000000000000000000000
000000000000000000000000000000000000000000000000000000000000000000000000000000000
000000000000000000000000000000000000000000000000000000000000000000000000000000000
000000000000000000000000000000000000000000000000000000000000000000000000000000000
000000000000000000000000000000000000000000000000000000000000000000000000000000000
000000000000000000000000000000000000000000000000000000000000000000000000000000000
000000000000000000000000000000000000000000000000000000000000000000000000000000000
000000000000000000000000000000000000000000000000000000000000000000000000000000000
000000000000000000000000000000000000000000000000000000000000000000000000000000000