10000000011111111111111111111100000000
10000000077000000000200000000100000000
10111111111111111111111111010100000000
10100000000000000000200001010100000000
10101111111111111111111001010100000000
10101000002000000000001001010100000000
10101111111111111111001001010100000000
10100000000000000001001001010100000000
10111111111111111001001001010100000000
10000000000000001001001001010100000000
11111111111111001001001001010100000000
10700000000001001001001001010100000000
11001111111001001001001001010100000000
11020000001000000000001000010100000000
11111111111111111111111111111100000000
00000000000000000000000000000000000000
00000000000000000000000000000000000000
00000000000000000000000000000000000000
00000000000000000000000000000000000000
00000000000000000000000000000000000000