100000000111111111111111111111111111111111111111111111111111111111111111000000000
100000000111111111111111111111111111111111111111111111111111111111111111000000000
100000000111111111111111111111111111111111111111111111111111111111111111000000000
111100111111111111111111111100000000000000000011111111111111111111111111000000000
111100111111110000000000000000000111100006000011111111111111111111111111000000000
111100000000000006000000111111111111100000000011111111111111111111111111000000000
111100111111110000000000000000000111111111111111111111111111111111111111000000000
111100111111111111111111111111100000070000000111111111111111111111111111000000000
111100111111111111111111111111100000700000000111111111111111111111111111000000000
111100111111111111111111111111100050000000000111111111111111111111111111000000000
111114111111111111111111111111111111100111111111111111111111111111111111000000000
111111111111111111111111111111111111100111111111111111111111111111111111000000000
111111111111111111111111111111111111100111111111111111111111111111111111000000000
111111111111111111111111111111111111100111111111111111111111111111111111000000000
111111111111111111111111100000000000000000000000000021111111111111111111000000000
111111111111111111111111100000000020000000000000000001111111111111111111000000000
111111111111111111111111111111111111100111111111111111111111111111111111000000000
111111111111111111111111111111111111100111111111111111111111111111111111000000000
111111111111111111111111111111111111100111111111111111111111111111111111000000000
111111111111111111111111111111111111100111111111111111111111111111111111000000000
111111111111111111111111111111111111100111111111111111111111111111111111000000000
111111111111111111111111111111100000000000000011111111111111111111111111000000000
111111111111111111111111111111100006000000060011111111111111111111111111000000000
111111111111111111111111111111100000000000000011111111111111111111111111000000000
111111111111111111111111111111111110111111011111111111111111111111111111000000000
111111111111111111111111111111111111111111111111111111111111111111111111000000000
111111111111111111111111111111111111111111111111111111111111111111111111000000000
111111111111111111111111111111111111111111111111111111111111111111111111000000000
111111111111111111111111111111111111111111111111111111111111111111111111000000000
111111111111111111111111111111111111111111111111111111111111111111111111000000000
111111111111111111111111111111111111111111111111111111111111111111111111000000000
111111111111111111111111111111111111111111111111111111111111111111111111000000000
111111111111111111111111111111111111111111111111111111111111111111111111000000000
111111111111111111111111111111111111111111111111111111111111111111111111000000000
111111111111111111111111111111111111111111111111111111111111111111111111000000000
111111111111111111111111111111111111111111111111111111111111111111111111000000000
111111111111111111111111111111111111111111111111111111111111111111111111000000000
111111111111111111111111111111111111111111111111111111111111111111111111000000000
000000000000000000000000000000000000000000000000000000000000000000000000000000000
000000000000000000000000000000000000000000000000000000000000000000000000000000000
000000000000000000000000000000000000000000000000000000000000000000000000000000000
000000000000000000000000000000000000000000000000000000000000000000000000000000000
000000000000000000000000000000000000000000000000000000000000000000000000000000000
000000000000000000000000000000000000000000000000000000000000000000000000000000000
000000000000000000000000000000000000000000000000000000000000000000000000000000000
000000000000000000000000000000000000000000000000000000000000000000000000000000000
000000000000000000000000000000000000000000000000000000000000000000000000000000000