100000000111111111111111111111111111111111111111111111111111111111111111000000000
100000000111111111111111111111111111111111111111111111111111111111111111000000000
100000000111111111111111111111111111111111111111111111111111111111111111000000000
111100111111111111111111111111111111111111111111111111111111111111111111000000000
111100111111111111111111111111111111111111111111111111111111111111111111000000000
111100000000000000000000003000000000000000000011111111111111111111111111000000000
111100111111111111111111111111111111111111111211111111111111111111111111000000000
111100000000000000000000000000000000000000000011111111111111111111111111000000000
111100111111111111111111111111111111111111111111111111111111111111111111000000000
111100000000000000000000000000000000000000000211111111111111111111111111000000000
111100111111111111111111111111111111111111111111111111111111111111111111000000000
111100000000000000000000000000000000000000000011111111111111111111111111000000000
111100111111111111111111111111111111111111111111111111111111111111111111000000000
111100000000000000000000000000000000000000000211111111111111111111111111000000000
111100111111111111111111111111111111111111111111111111111111111111111111000000000
111100000000000000000000000200000000000000000011111111111111111111111111000000000
111100111111111111111111111111111111111111111111111111111111111111111111000000000
111100000000000000000000000000000000000000003011111111111111111111111111000000000
111100111111111111111111111111111111111111111111111111111111111111111111000000000
111100111111111111111111111111111111111111111111111111111111111111111111000000000
111100000000000000000000000000000000000000000311111111111111111111111111000000000
111100111111111111111111111111111111111111111111111111111111111111111111000000000
111100111111111111111111111111111111111111111111111111111111111111111111000000000
111100000000000000000000000000000000000000000311111111111111111111111111000000000
111100111111111111111111111111111111111111111111111111111111111111111111000000000
111100000000000000000000000000000000000000003011111111111111111111111111000000000
111100111111111111111111111111111111111111111111111111111111111111111111000000000
111100000000000000000000000000000000000000000311111111111111111111111111000000000
111100111111111111111111111111111111111111111111111111111111111111111111000000000
111100000000000000000000000000000000000000000311111111111111111111111111000000000
111100111111111111111111111111111111111111111111111111111111111111111111000000000
111100000000000000000000000000000000000000000311111111111111111111111111000000000
111100111111111111111111111111111111111111111111111111111111111111111111000000000
111100000000000000000000000000000000000000000511111111111111111111111111000000000
111100111111111111111111111111111111111111111111111111111111111111111111000000000
111100111111111111111111111111111111111111111051111111111111111111111111000000000
111140000000000000000000000000000000000000000001111111111111111111111111000000000
111111111111111111111111111111111111111111111111111111111111111111111111000000000
000000000000000000000000000000000000000000000000000000000000000000000000000000000
000000000000000000000000000000000000000000000000000000000000000000000000000000000
000000000000000000000000000000000000000000000000000000000000000000000000000000000
000000000000000000000000000000000000000000000000000000000000000000000000000000000
000000000000000000000000000000000000000000000000000000000000000000000000000000000
000000000000000000000000000000000000000000000000000000000000000000000000000000000
000000000000000000000000000000000000000000000000000000000000000000000000000000000
000000000000000000000000000000000000000000000000000000000000000000000000000000000
000000000000000000000000000000000000000000000000000000000000000000000000000000000