100000000111111111111111111111111111111111111111111111111111111111111111000000000
100000000111111111111111111111111111111111111111111111111111111111111111000000000
100000000111111111111111111111111111111111111111111111111111111111111111000000000
111100111111111111111111111111111111111111111111111111111111111111111111000000000
111100111111111111111111111111111111111111111111111111111111111111111111000000000
111100007000000000000000003000000000000000000011111111111111111111111111000000000
111100111111111111111111111111111111111111111111111111111111111111111111000000000
111100007000000000000000000000000000000000000211111111111111111111111111000000000
111100111111111111111111111111111111111111111111111111111111111111111111000000000
111100007000000000000000000000000000000000000211111111111111111111111111000000000
111100111111111111111111111111111111111111111111111111111111111111111111000000000
111100007000000000002000000000000000000000000011111111111111111111111111000000000
111100111111111111111111111111111111111111111111111111111111111111111111000000000
111100007000000000000000000000000000000000000211111111111111111111111111000000000
111100111111111111111111111111111111111111111111111111111111111111111111000000000
111100000000700000000000000200000000000000000011111111111111111111111111000000000
111100111111111111111111111111111111111111111111111111111111111111111111000000000
111100070000000000000000000000000000000000003011111111111111111111111111000000000
111100111111111111111111111111111111111111111111111111111111111111111111000000000
111100111111111111111111111111111111111111111111111111111111111111111111000000000
111100000007000000000000000000000000000000000311111111111111111111111111000000000
111100111111111111111111111111111111111111111111111111111111111111111111000000000
111104111111111111111111111111111111111111111111111111111111111111111111000000000
111100070000000000000000000000000000000000000311111111111111111111111111000000000
111104111111111111111111111111111111111111111111111111111111111111111111000000000
111100070000000000000000000000000000000000003011111111111111111111111111000000000
111104111111111111111111111111111111111111111111111111111111111111111111000000000
111100000007000000000000000000000000000000000311111111111111111111111111000000000
111104111111111111111111111111111111111111111111111111111111111111111111000000000
111100070000000000000000000000000000000000000311111111111111111111111111000000000
111104111111111111111111111111111111111111111111111111111111111111111111000000000
111100070000000000000000000000000000000000000311111111111111111111111111000000000
111104111111111111111111111111111111111111111111111111111111111111111111000000000
111100070000000000000000000000000000000000000511111111111111111111111111000000000
111104111111111111111111111111111111111111111111111111111111111111111111000000000
111100111111111111111111111111111111111111111051111111111111111111111111000000000
111104070000000000000000000000000000000000000001111111111111111111111111000000000
111111111111111111111111111111111111111111111111111111111111111111111111000000000
000000000000000000000000000000000000000000000000000000000000000000000000000000000
000000000000000000000000000000000000000000000000000000000000000000000000000000000
000000000000000000000000000000000000000000000000000000000000000000000000000000000
000000000000000000000000000000000000000000000000000000000000000000000000000000000
000000000000000000000000000000000000000000000000000000000000000000000000000000000
000000000000000000000000000000000000000000000000000000000000000000000000000000000
000000000000000000000000000000000000000000000000000000000000000000000000000000000
000000000000000000000000000000000000000000000000000000000000000000000000000000000
000000000000000000000000000000000000000000000000000000000000000000000000000000000